################################
###############  ###############
##############    ##############
#############      #############
############        ############
###########          ###########
##########            ##########
#########              #########
########                ########
#######                  #######
######                    ######
#####                      #####
####                        ####
###                          ###
##                            ##
#                              #
#                              #
##                            ##
###                          ###
####                        ####
#####                      #####
######                    ######
#######                  #######
########                ########
#########              #########
##########            ##########
###########          ###########
############        ############
#############      #############
##############    ##############
###############  ###############
################################