................................
................................
................................
................................
................................
................................
................................
................................
......####################......
......####################......
......##................##......
......##................##......
......##................##......
......##................##......
......##................##......
......##................##......
......##................##......
......##................##......
......##................##......
......##................##......
......##................##......
......##................##......
......##................##......
......##................##......
................................
................................
................................
................................
................................
................................
................................
................................